6 6
1 1
X 0 X X X T
0 0 0 0 X 0
0 X X D X 0
0 0 0 0 X 0
X X X 0 X 0
X X X 0 0 0