10 10
9 9
0 0 0 0 0 0 0 0 0 0
0 X X X X X X X X 0
0 X 0 0 0 0 0 0 X 0
0 X 0 X X X X 0 X 0
0 X 0 X P X X 0 X 0
0 X 0 X 0 0 0 0 X 0
0 X 0 X X X X X X 0
0 X 0 0 0 0 0 0 0 0
0 X X X X X X X X X
0 0 0 0 0 0 0 0 0 0