9 9
1 1
X 0 0 0 0 0 X X 0
X 0 X 0 X 0 0 0 0
X 0 0 0 X 0 X X X
X 0 X 0 X 0 0 0 X
0 0 X D X X X 0 X
0 0 0 0 0 0 0 0 X
X X 0 X X X X 0 X
X X 0 0 0 G 0 P X
X X X X X X X X X