9 6
0 2
X X 0 0 0 0
X X D X 0 X
X X 0 X 0 X
X X X X 0 X
0 0 0 0 0 D
0 X D 0 X 0
0 X X 0 X P
0 G X 0 0 0
X 0 0 0 X 0